262222622222262222622262226
245442414242222222222222222
243444444224322622144422622
214441434442422226446442222
224422235544226552436442226
222442234444152442234322222
224444221422246444224462222
222441244442444244424344262
624422244442144241224423222
225332244422443442445444222
224441214442444344345312542
222444244444344544423322442
214444221444544244224424444
222445222144544254244422442
225444222444444544224442242
222142262243444214425444342
222244224441242144422443342
262444123144522444424421226
222244422444242144124442222
222444224454242444444444222
224442223344432554444412222
262443214324352434464422262
226243524421424434464344122
222143424335524335444332222
234443422244122255441222262
244443421144426622622622622
622262226226262222222222226
s(1,25).e(26,12)
000000000000000000000000000
000100000000000000000000000
000000000000000000000000000
000000000000000000000000000
000000000000000000000000000
000000000000000000000000000
000000000000000000000000000
000000001000000000000000000
000000000000000000000000000
000000000000000000000000000
000000000000000000000000000
000000000000000000000000000
000000000000000000000000000
000000000000000000000000000
000000000000000000000000000
000000000000000000000000000
000000000000000000000000000
000000000000000000000000000
000000000000000000000000000
000000000000000000000000000
000000000000000000000000000
000000000000000000000000000
000000000000000000000000000
000000000000000000000000000
000020000000000000000000000
000000000000000000000000000
000000000000000000000000000