262222622222262222622262226
222222222622222222222222222
222222222222222222222222222
222622222222122224444152222
222222266222422334444443226
222222244222422442222544222
226222444422332442262544222
222222422412444412222244222
622224422442452222222241222
222224422442412262222442622
214455422462444222222442222
222444424422444222144642222
222441224422242224444442222
244422224452242224422444122
214422222442244124422222222
646452225442242226462222222
222442224422642222442222222
223442224422442222442226226
224322224422442224452222222
221222222422244124422222222
222222225422242222434442222
222222225422242222434642222
262624344436645262422242222
222224242444444222422241222
222221222444444222122244444
222222222222222222224222222
622262226226262262222222226
s(1,13).e(26,24)
000000000000000000000000000
000000000000000000000000000
000000000000000000000000000
000000000000000000000000000
000000000000000000000000000
000000000000000000000000000
000000000000000000000000000
000000000000000000000000000
000000000000000000000000000
000000000000000000000000000
000000000000000000000000000
000000000000000000000000000
000000000000000000000000000
000000000000000000000000000
000000000000000000000000000
000000000000000000000000000
000000000000000000000000000
000000000000000000000000000
000000000000000000000000000
000000000000000000000000000
000000000000000000000000000
000000000000000000000000000
000000000000000000000000000
000000000000000000000000000
000000000000000000000000000
000000000000000000000000000
000000000000000000000000000