262222622222262222622264226
222222226222222222224244122
262221442222222222223554422
222644444342262222544444222
222442244522222264445444226
222442241262422224412222222
262244244422322224442222222
222444226424412225541222262
622223222424442262234222222
222644224414542222442622262
222641224444544224412222222
262244222442244224422222222
222444222222244224446222222
222245222222244222324422222
221445222442146444464434262
264422214444432222244452222
244522244524422222244452222
244526244522222262244222226
264222254442221222244622222
224462243444444442214226222
221442222144444442254422222
222244222224415421254434222
222444342622625444444122222
222441222222243444422222222
262244422222222653562222622
222214422222222224222222222
622262426226262222222222226
s(6,26).e(23,0)
000000000000000000000000000
000000000000000000000000000
000000000000000000000000000
000000000000000000000000000
000000000000000000000000000
000000000000000000000000000
000000000000000000000000000
000000000000000000000000000
000000000000000000000000000
000000000000000000000000000
000000000000000000000000000
000000000000000000000000000
000000000000000000000000000
000000000000000000000000000
000000000000000000000000000
000000000000000000000000000
000000000000000000000000000
000000000000000000000000000
000000000000000000000000000
000000000000000000000000000
000000000000000000000000000
000000000000000000000000000
000000000000000000000000000
000000000000000000000000000
000000000000000000000000000
000000000000000000000000000
000000000000000000000000000