262222622222262222622264226
222222226222222222224244122
262221442222222222223544422
222644444342262222544444222
222442244522222264444444226
222442241262422224412222222
262244244422322224444222222
222444226424412225541222262
622243222424442262434222222
222644224414542222442622262
222441224444544224412222222
262244222442244224422222222
222444222222244224446222222
222445222222244222344422222
221445222442146444464434262
264442214444432222244452222
244522244524422222244452222
244526244522222262244222226
244222254442221222244622222
224442243444444442214426222
221442222144444442254422222
222244222224415421254434222
222444342622625444444122222
224441222222243444422222222
262444422222222653562222622
222214422222222224222222222
622264426226262222222222226
s(6,26).e(23,0)
000000000000000000000000000
000000000000000000008000000
000000000000000000000000000
000000000000000000000000000
000000000000000000000000000
000000000000000000000000000
000000000000000000001000000
000003000004000000000000000
000000000000000000000000000
000000000000000000000000000
000000000000000000000000000
000000000000000000000000000
000000000000000000000000000
000000000000000000000000000
000000000000050000000007000
000020000000000000000000000
000000000000000000000000000
000000000000000000000000000
000000000000000000000000000
000000000000000000000000000
000000000000000000000000000
000000000000000000000006000
000000000000000000000000000
000100000000000000000000000
000000000000000000000000000
000000000000000000000000000
000000000000000000000000000