262222622222262222622262226
222422222222222222222222222
222322622622226246222222222
214422225522222232222622222
444422144226221442222222226
122144224441222444412222222
226244262444422465443422222
222442224422422454422622222
622244224422444424422222222
222242244224444244342222222
222442244422222224122226222
222244225412625522442222222
262554224442224422442542222
221444224444444462426543422
222442222412441422422445262
222422262222222422444445222
224422222222224422442412222
224414222254414422452222226
225443225444444424452262222
225444425442222224422222222
622622422244444621424412222
222224426214424222444441226
222434222222244224415442222
226224422442224422222534414
222224124441244262622424444
222224444444442222222222222
622262226226262222262222226
s(26,24).e(0,4)
000000000000000000000000000
000600000000000000000000000
000000000000000070000000000
000000000000000000000000000
000000040000000000000000000
000000000000000000000000000
000000000000000000030000000
000000000000000000000000000
000000000000000000000000000
000000000000000000020000000
000000000000000000000000000
000000000000000000000000000
001000000000000000000000000
000000000000000000000000800
000000000000000000000000000
000000000000000000000000000
000000000000000000020000000
000005000000000000000000000
000010000000000000000000000
000000000000000000000000000
000000000000000000000000000
000000000000000000000000000
000000000000000000000010000
000000000000000000000000000
000000000000000000000000000
000000200000000000000000000
000000000000000000000000000